map_cols=18
map_rows=13
tile_width=33
tile_height=33
tile_path=map\¾­µäÄ§ËþÓÎÏ·È«Ì×ËØ²Ä-08a_°®¸øÍø_aigei_com.jpg
tile_grid_id=1
barrier_layer_name=obstacle
<layer name=background>
1,1,1,1,1,1,1,1,1,1,1,1,1,1,1,1,1,1,
1,1,1,1,1,1,599,1,1,1,1,1,1,1,1,1,1,1,
1,1,1,1,1,1,1,1,1,1,1,1,1,1,1,1,1,1,
1,1,1,1,1,1,1,1,1,1,1,1,1,1,1,1,1,1,
1,1,1,1,1,1,1,1,1,1,1,1,1,1,1,1,1,1,
1,1,1,1,1,1,1,1,1,1,1,1,1,1,1,1,1,1,
1,1,1,1,1,1,1,1,1,1,1,1,1,1,1,1,1,1,
1,1,1,1,1,1,1,1,1,1,1,1,1,1,1,1,1,1,
1,1,1,1,1,1,1,1,1,1,1,1,1,1,1,1,1,1,
1,1,1,1,1,1,1,1,1,1,1,1,1,1,1,1,1,1,
1,1,1,1,1,1,1,1,1,1,1,1,1,1,1,1,1,1,
1,1,1,1,1,1,1,1,1,1,1,1,1,1,1,1,1,1,
1,1,1,1,1,1,1,1,1,1,1,1,1,1,1,1,1,1
</layer>
<layer name=obstacle>
88,88,88,88,88,88,88,88,88,88,88,88,88,88,88,88,88,88,
88,0,0,0,0,88,0,0,0,0,0,0,0,0,0,0,0,88,
88,0,0,0,0,88,440,440,440,440,440,440,440,440,440,440,0,88,
88,0,0,0,0,88,0,0,0,0,0,440,0,0,0,440,0,88,
88,0,0,0,0,88,0,0,0,440,0,440,0,0,0,440,0,88,
88,0,0,0,0,88,440,0,440,440,0,440,440,440,0,440,0,88,
88,0,0,0,0,88,0,0,0,440,0,0,0,0,0,440,0,88,
88,0,0,0,0,88,0,0,0,440,0,440,440,440,440,440,0,88,
88,0,0,0,0,88,440,0,440,440,0,0,0,0,0,0,0,88,
88,0,0,0,0,88,0,0,0,440,440,0,440,440,440,0,440,88,
88,0,0,0,0,88,0,0,0,440,0,0,0,440,0,0,0,88,
88,0,0,0,0,88,0,0,0,440,0,0,0,440,0,0,0,88,
88,88,88,88,88,88,88,88,88,88,88,88,88,88,88,88,88,88
</layer>